#####################
#...................#
#....#..............#
#....######.........#
#.........#.........#
#.........#.........#
#################..##